ADNP	ADNP	activity-dependent neuroprotector
AHR	AHR	aryl hydrocarbon;aryl hydrocarbon receptor
AKAP9	AKAP9	kinase anchor protein 9;A-kinase anchor protein 9
AMEL	AMEL	amelogenin
BACH1	BACH1	basic leucine zipper transcription factor 1;BTB and CNC homology 1;BTB and CNC-like 1
BACH2	BACH2	BTB and CNC-like protein 2
BDNF	BDNF	brain-derived neurotrophic factor;brain derived neurotrophic factor
BHLHB2	BHLHB2	basic helix-loop-helix domain-containing protein class B2
BMP2	BMP2	bone morphogenetic protein 2
CAND1	CAND1	cullin-associated and neddylation-dissociated protein 1
CARD4	CARD4	caspase recruitment domain family member 4
CILP	CILP	cartilage intermediate layer protein
CMOS	CMOS;C-MOS	oocyte maturation factor
CXCR4	CXCR4	chemokine C-X-C motif receptor 4;C-X-C chemokine receptor type 4
DLL1	DLL1;DLL	distal-less
DNAH3	DNAH3	dynein axonemal heavy chain 3;dynein axonemal heavy chain 3s
ECEL1	ECEL1;ECEL	endothelin converting;endothelin converting enzyme-like 1
ENC1	ENC1	ectodermal neural cortex 1
EXPH5	EXPH5	exophilin;exophilin 5;exophilin-5;exophilin protein 5
FSHR	FSHR	follicle stimulating hormone;follicle-stimulating hormone receptor
FSTL5	FSTL5	follistatin-like protein 5;follistatin-like 5
GALR1	GALR1	galanin receptor 1
GHSR	GHSR	growth hormone secretagogue
GPR37	GPR37	G protein-coupled receptor 37;receptor 37
HLCS	HLCS	holocarboxylase synthetase
INHIBA	INHIBA;INHBA	inhibin beta A
KIAA1217	KIAA1217	sickle tail protein
KIAA1549	KIAA1549	KIAA1549
KIAA2018	KIAA2018	KIAA2018
KIF24	KIF24	kinesin family member 24
LRRN1	LRRN1	leucine rich repeat neuronal 1;leucine-rich repeat neuronal 1
LZTS1	LZTS1	leucine zipper tumor suppressor
MC1R	MC1R	melanocortin receptor 1;melanocortin 1 receptor
MKL1	MKL1	megakaryoblastic leukemia;leukemia translocation 1;leukemia 1 protein
MLL3	MLL3	leukemia 3;myeloid/lymphoid;mixed-lineage leukemia 3
MSH6	MSH6	mutS protein 6
MXRA5	MXRA5	matrix-remodelling associated 5;matrix-remodelling associated protein 5
MYH2	MYH2	myosin heavy chain
NGFB	NGFB	nerve growth factor beta;growth factor beta polypeptide;nerve growth-factor beta
NKTR	NKTR	natural killer-tumor;NK-tumor recognition protein
NOS1	NOS1	nitric oxide synthase 1
NT3	NT3	neurotrophin 3;neurotrophin-3
PDC	PDC	phosducin
PNN	PNN	pinin;pinin desmosome associated protein
PRLR	PRLR	prolactin receptor;prolactin
PTGER4	PTGER4	prostaglandin E receptor 4;receptor 4 subtype EP4
PTPN	PTPN;PTPN12	protein tyrosine phosphatase;tyrosine phosphatase non-receptor type 12
R35	R35	35 G protein-coupled receptor;G protein-coupled receptor R35;RNA fingerprint protein 35
RAG1	RAG1;RAG-1	recombination activating protein 1;recombination-activating protein 1
RAG2	RAG2;RAG-2	recombination activating protein 2;recombination-activating protein 2
REV3L	REV3L	polymerase zeta catalytic subunit;REV3-like
RHO	RHO	rhodopsin
SLC30A1	SLC30A1	solute carrier family 30 member 1
SLC8A1	SLC8A1	solute carrier family 8 member 1
SLC8A3	SLC8A3	solute carrier family 8 member 3
SNCAIP	SNCAIP;SINCAIP	synuclein alpha interacting protein;synuclein alpha-interacting protein
SOCS5	SOCS5	supressor of cytokine signaling 5
TRAF6	TRAF6	TNF receptor-associated factor 6
UBN1	UBN1	ubinuclein 1
VCPIP	VCPIP;VCPIP1	valosin-containing protein;p97/p47 complete interacting protein 1
ZEB2	ZEB2	zinc finger homeobox protein
ZFP36L1	ZFP36L1	zinc finger protein 36;protein 36 C3H type-like 1
12S	12S	12S ribosomal RNA; small subunit ribosomal;mitochondrion complete genome;mitochondrial DNA complete genome;mitochondrion partial genome
16S	16S	16S ribosomal RNA;large subunit ribosomal;mitochondrion complete genome;mitochondrial DNA complete genome;mitochondrion partial genome
CO1	CO1;COX1;COI	cytochrome oxidase subunit 1;oxidase subunit I;oxidase subunit 1;mitochondrion complete genome;mitochondrial DNA complete genome;mitochondrion partial genome
CYTB	CYTB;CYT-B	cytochrome b;mitochondrion complete genome;mitochondrial DNA complete genome;mitochondrion partial genome
ND1	ND1	dehydrogenase subunit 1;mitochondrion complete genome;mitochondrial DNA complete genome;mitochondrion partial genome
ND2	ND2	dehydrogenase subunit 2;mitochondrion complete genome;mitochondrial DNA complete genome;mitochondrion partial genome
ND4	ND4	dehydrogenase subunit 4;mitochondrion complete genome;mitochondrial DNA complete genome;mitochondrion partial genome